{
    "FIPS" : "30",
    "common_name" : "Montana",
    "full_name" : "State of Montana",
    "map_color" : "#32FFA7",
    "flag_loc" : "montana_flag.png",
    "population" : 1084225,
    "land_area" : 147040,
    "abbreviation" : "MT",
    "motto" : "montana_motto",
    "nickname" : "montana_nickname",
    "capital" : "Helena",
    "federal_court_circuit" : 9,
    "descriptors" : [
        "MONTANA",
        "WEST",
        "MOUNTAIN"
    ],
    "counties" : [
        "30001",
        "30003",
        "30005",
        "30007",
        "30009",
        "30011",
        "30013",
        "30015",
        "30017",
        "30019",
        "30021",
        "30023",
        "30025",
        "30027",
        "30029",
        "30031",
        "30033",
        "30035",
        "30037",
        "30039",
        "30041",
        "30043",
        "30045",
        "30047",
        "30049",
        "30051",
        "30053",
        "30057",
        "30055",
        "30059",
        "30061",
        "30063",
        "30065",
        "30067",
        "30069",
        "30071",
        "30073",
        "30075",
        "30077",
        "30079",
        "30081",
        "30083",
        "30085",
        "30087",
        "30089",
        "30091",
        "30093",
        "30095",
        "30097",
        "30099",
        "30101",
        "30103",
        "30105",
        "30107",
        "30109",
        "30111"
    ]
}
