{
    "FIPS" : "06",
    "common_name" : "California",
    "full_name" : "State of California",
    "map_color" : "#DAFF32",
    "flag_loc" : "california_flag.png",
    "population" : 39538223,
    "land_area" : 163695,
    "abbreviation" : "CA",
    "motto" : "california_motto",
    "nickname" : "california_nickname",
    "capital" : "Sacramento",
    "federal_court_circuit" : 9,
    "descriptors" : [
        "CALIFORNIA",
        "WEST",
        "PACIFIC"
    ],
    "counties" : [
        "06001",
        "06003",
        "06005",
        "06007",
        "06009",
        "06011",
        "06013",
        "06015",
        "06017",
        "06019",
        "06021",
        "06023",
        "06025",
        "06027",
        "06029",
        "06031",
        "06033",
        "06035",
        "06037",
        "06039",
        "06041",
        "06043",
        "06045",
        "06047",
        "06049",
        "06051",
        "06053",
        "06055",
        "06057",
        "06059",
        "06061",
        "06063",
        "06065",
        "06067",
        "06069",
        "06071",
        "06073",
        "06075",
        "06077",
        "06079",
        "06081",
        "06083",
        "06085",
        "06087",
        "06089",
        "06091",
        "06093",
        "06095",
        "06097",
        "06099",
        "06101",
        "06103",
        "06105",
        "06107",
        "06109",
        "06111",
        "06113",
        "06115"
    ]
}
